S#########
.....###.#
#.##.#...#
#.#....#.#
#..###.#.#
##...#.#.#
####.###.#
#....#...#
#.##.##.##
#.#..##...
#.#.#.#.#.
###.#...#. 
G...#.###.
